"ulx sasay"	"Grants access to the ulx sasay command"
"ulx votekickminvotes"	""
"ulx notepad"	"Grants access to the ulx notepad command"
"ulx unvotegag"	"Grants access to the ulx unvotegag command"
"ulx noaes"	"Grants access to the ulx noaes command"
"ulx stopsounds"	"Grants access to the ulx stopsounds command"
"ulx rslots"	" - Sets the number of reserved slots, only applicable for modes 1 and 2."
"ulx votemapsuccessratio"	""
"ulx vote"	"Grants access to the ulx vote command"
"ulx give"	"Grants access to the ulx give command"
"ulx motd"	"Grants access to the ulx motd command"
"ulx timescale"	"Grants access to the ulx timescale command"
"wuma clearloadout"	"A privilege from CAMI"
"ulx hook"	"Grants access to the ulx hook command"
"wuma setlimit"	"A privilege from CAMI"
"ulx scale"	"Grants access to the ulx scale command"
"ulx srunscript"	"Grants access to the ulx srunscript command"
"ulx asay"	"Grants access to the ulx asay command"
"ulx giveammo"	"Grants access to the ulx giveammo command"
"ulx votemap2successratio"	""
"ulx votemapvetotime"	""
"ulx hp"	"Grants access to the ulx hp command"
"ulx whip"	"Grants access to the ulx whip command"
"ulx unigniteall"	"Grants access to the ulx unigniteall command"
"fpp_touchotherplayersprops"	"A privilege from CAMI"
"ulx ban"	"Grants access to the ulx ban command"
"ulx votemapmintime"	""
"wuma unsetuserlimit"	"A privilege from CAMI"
"wuma removeloadout"	"A privilege from CAMI"
"ulx votemuteminvotes"	""
"ulx fakeban"	"Grants access to the ulx fakeban command"
"ulx kick"	"Grants access to the ulx kick command"
"ulx playsound"	"Grants access to the ulx playsound command"
"ulx setwarp"	"Grants access to the ulx setwarp command"
"ulx ungimp"	"Grants access to the ulx ungimp command"
"ulx votemapminvotes"	""
"ulx soundlist"	"Grants access to the ulx soundlist command"
"ulx chattime"	"<time> - Players can only chat every x seconds (anti-spam). 0 to disable."
"ulx watchlist"	"Grants access to the ulx watchlist command"
"ulx motddisabledmessage"	"<0/1> - Show disabled message when MOTD command is run if MOTD is disabled by the server. 0 is off."
"ulx removeragdolls"	"Grants access to the ulx removeragdolls command"
"ulx respawn"	"Grants access to the ulx respawn command"
"ulx resettimescale"	"Grants access to the ulx resettimescale command"
"ulx freeze"	"Grants access to the ulx freeze command"
"ulx spectate"	"Grants access to the ulx spectate command"
"ulx enter"	"Grants access to the ulx enter command"
"ulx gag"	"Grants access to the ulx gag command"
"ulx votekicksuccessratio"	""
"ulx thirdperson"	"Grants access to the ulx thirdperson command"
"ulx votebanminvotes"	""
"ulx votemutesuccessratio"	""
"ulx votekick"	"Grants access to the ulx votekick command"
"ulx maprestart"	"Grants access to the ulx maprestart command"
"ulx userdeny"	"Grants access to the ulx userdeny command"
"wuma gui"	"A privilege from CAMI"
"ulx srunscriptcl"	"Grants access to the ulx srunscriptcl command"
"ulx votemapenabled"	""
"ulx explode"	"Grants access to the ulx explode command"
"ulx cexec"	"Grants access to the ulx cexec command"
"ulx physgunplayer"	"Ability to physgun other players"
"ulx version"	"Grants access to the ulx version command"
"ulx bancheck"	"Grants access to the ulx bancheck command"
"ulx return"	"Grants access to the ulx return command"
"ulx userdenyid"	"Grants access to the ulx userdenyid command"
"ulx help"	"Grants access to the ulx help command"
"wuma removeuserloadout"	"A privilege from CAMI"
"ulx banip"	"Grants access to the ulx banip command"
"ulx profile"	"Grants access to the ulx profile command"
"ulx launch"	"Grants access to the ulx launch command"
"wuma setuserprimaryweapon"	"A privilege from CAMI"
"ulx bring"	"Grants access to the ulx bring command"
"ulx votemap2"	"Grants access to the ulx votemap2 command"
"ulx ssp"	"Grants access to the ulx ssp command"
"ulx ip"	"Grants access to the ulx ip command"
"ulx setgroupcantarget"	"Grants access to the ulx setgroupcantarget command"
"ulx logspawns"	"Log when players spawn objects (props, effects, etc)"
"ulx logechocolorplayer"	"The color to use for players when ulx logEchoColorPlayerAsGroup is set to 0."
"ulx trail"	"Grants access to the ulx trail command"
"fpp_cleanup"	"A privilege from CAMI"
"ulx cloak"	"Grants access to the ulx cloak command"
"ulx noclip"	"Grants access to the ulx noclip command"
"ulx removeuserid"	"Grants access to the ulx removeuserid command"
"ulx sgive"	"Grants access to the ulx sgive command"
"ulx gravity"	"Grants access to the ulx gravity command"
"ulx tsay"	"Grants access to the ulx tsay command"
"ulx wardrobeblacklist"	"Grants access to the ulx wardrobeblacklist command"
"wuma changeinheritance"	"A privilege from CAMI"
"ulx material"	"Grants access to the ulx material command"
"ulx warp"	"Grants access to the ulx warp command"
"ulx aes"	"Grants access to the ulx aes command"
"ulx ssendlua"	"Grants access to the ulx ssendlua command"
"ulx hide"	"Grants access to the ulx hide command"
"ulx welcomemessage"	"<msg> - This is shown to players on join."
"ulx psay"	"Grants access to the ulx psay command"
"ulx timedcmd"	"Grants access to the ulx timedcmd command"
"ulx votegagsuccessratio"	""
"ulx model"	"Grants access to the ulx model command"
"ulx unadministrate"	"Grants access to the ulx unadministrate command"
"xgui_gmsettings"	"Allows changing of gamemode-specific settings on the settings tab in XGUI."
"ulx unvotemute"	"Grants access to the ulx unvotemute command"
"ulx ungag"	"Grants access to the ulx ungag command"
"ulx tsaycolor"	"Grants access to the ulx tsaycolor command"
"ulx voteban"	"Grants access to the ulx voteban command"
"ulx setname"	"Grants access to the ulx setname command"
"ulx banid"	"Grants access to the ulx banid command"
"ulx seeasay"	"Ability to see 'ulx asay'"
"ulx csay"	"Grants access to the ulx csay command"
"ulx adduser"	"Grants access to the ulx adduser command"
"ulx strip"	"Grants access to the ulx strip command"
"ulx forcewardrobe"	"Grants access to the ulx forcewardrobe command"
"ulx map"	"Grants access to the ulx map command"
"ulx teleport"	"Grants access to the ulx teleport command"
"ulx gethooktable"	"Grants access to the ulx gethooktable command"
"wuma setprimaryweapon"	"A privilege from CAMI"
"ulx sendlua"	"Grants access to the ulx sendlua command"
"wuma unrestrict"	"A privilege from CAMI"
"ulx logechocolors"	"Whether or not echoed commands in chat are colored"
"ulx forcerespawn"	"Grants access to the ulx forcerespawn command"
"ulx friends"	"Grants access to the ulx friends command"
"ulx sban"	"Grants access to the ulx sban command"
"ulx goto"	"Grants access to the ulx goto command"
"ulx tempadduserid"	"Grants access to the ulx tempadduserid command"
"ulx votegag"	"Grants access to the ulx votegag command"
"ulx shock"	"Grants access to the ulx shock command"
"ulx surl"	"Grants access to the ulx surl command"
"ulx thetime"	"Grants access to the ulx thetime command"
"ulx hiddenecho"	"Ability to see hidden echoes"
"ulx pgag"	"Grants access to the ulx pgag command"
"ulx rslotsvisible"	" - Sets whether slots are visible. See config for more information."
"ulx forceresetwardrobe"	"Grants access to the ulx forceresetwardrobe command"
"ulx serverinfo"	"Grants access to the ulx serverinfo command"
"ulx unblind"	"Grants access to the ulx unblind command"
"ulx uncloak"	"Grants access to the ulx uncloak command"
"ulx kickafternamechanges"	"<number> - Players can only change their name x times every ulx_kickAfterNameChangesCooldown seconds. 0 to disable."
"wuma adduserloadout"	"A privilege from CAMI"
"ulx jail"	"Grants access to the ulx jail command"
"ulx gimp"	"Grants access to the ulx gimp command"
"ulx sspdel"	"Grants access to the ulx sspdel command"
"ulx donate"	"Grants access to the ulx donate command"
"ulx dban"	"Grants access to the ulx dban command"
"ulx luarun"	"Grants access to the ulx luarun command"
"ulx votegagminvotes"	""
"ulx frags"	"Grants access to the ulx frags command"
"ulx unpgag"	"Grants access to the ulx unpgag command"
"ulx votemute"	"Grants access to the ulx votemute command"
"ulx logechocolorplayerasgroup"	"Whether or not to use group colors for players."
"ulx removetrail"	"Grants access to the ulx removetrail command"
"ulx resetmaterial"	"Grants access to the ulx resetmaterial command"
"wuma personalloadout"	"A privilege from CAMI"
"ulx logdir"	"The log dir under garrysmod/data"
"wuma setuserenforceloadout"	"A privilege from CAMI"
"ulx removegroup"	"Grants access to the ulx removegroup command"
"ulx motdurl"	"MOTD URL to use if ulx showMotd is 3."
"ulx ent"	"Grants access to the ulx ent command"
"ulx slay"	"Grants access to the ulx slay command"
"wuma restrictuser"	"A privilege from CAMI"
"ulx ungod"	"Grants access to the ulx ungod command"
"ulx url"	"Grants access to the ulx url command"
"ulx logechocoloreveryone"	"The color to use when everyone is targeted in echoes"
"ulx printhooks"	"Grants access to the ulx printhooks command"
"ulx jumppower"	"Grants access to the ulx jumppower command"
"ulx cancelcmd"	"Grants access to the ulx cancelcmd command"
"ulx armor"	"Grants access to the ulx armor command"
"wuma changesettings"	"A privilege from CAMI"
"helix - manage pac"	"A privilege from CAMI"
"wuma addloadout"	"A privilege from CAMI"
"ulx userallowid"	"Grants access to the ulx userallowid command"
"ulx bot"	"Grants access to the ulx bot command"
"ulx deaths"	"Grants access to the ulx deaths command"
"ulx convar"	"Grants access to the ulx convar command"
"ulx mechatenabled"	"Allow players to use '/me' in chat. 0 = Disabled, 1 = Sandbox only (Default), 2 = Enabled"
"ulx watch"	"Grants access to the ulx watch command"
"ulx resetmap"	"Grants access to the ulx resetmap command"
"ulx groupallow"	"Grants access to the ulx groupallow command"
"ulx jailtp"	"Grants access to the ulx jailtp command"
"ulx seesasay"	"Ability to see \"ulx sasay\""
"ulx logspawnsecho"	"Echo spawns to players in server. -1 = Off, 0 = Console only, 1 = Admins only, 2 = All players. (Echoes to console)"
"fpp_settings"	"A privilege from CAMI"
"ulx csaycolor"	"Grants access to the ulx csaycolor command"
"ulx mute"	"Grants access to the ulx mute command"
"ulx blind"	"Grants access to the ulx blind command"
"ulx notifications"	"Grants access to the ulx notifications command"
"ulx god"	"Grants access to the ulx god command"
"ulx removeuser"	"Grants access to the ulx removeuser command"
"ulx removehook"	"Grants access to the ulx removehook command"
"ulx usermanagementhelp"	"Grants access to the ulx usermanagementhelp command"
"ulx getcommandtable"	"Grants access to the ulx getcommandtable command"
"ulx tempadduser"	"Grants access to the ulx tempadduser command"
"ulx userallow"	"Grants access to the ulx userallow command"
"ulx logevents"	"Log events (player connect, disconnect, death)"
"fprofiler"	"A privilege from CAMI"
"ulx votemapwaittime"	""
"ulx voteecho"	""
"ulx sconvar"	"Grants access to the ulx sconvar command"
"wuma setenforceloadout"	"A privilege from CAMI"
"ulx who"	"Grants access to the ulx who command"
"ulx unban"	"Grants access to the ulx unban command"
"ulx cleardecals"	"Grants access to the ulx cleardecals command"
"ulx logfile"	"Log to file (Can still echo if off). This is a global setting, nothing will be logged to file with this off."
"ulx kickafternamechangescooldown"	"<time> - Players can change their name ulx_kickAfterXNameChanges times every x seconds."
"ulx runscriptcl"	"Grants access to the ulx runscriptcl command"
"ulx kickafternamechangeswarning"	"<1/0> - Display a warning to users to let them know how many more times they can change their name."
"ulx maul"	"Grants access to the ulx maul command"
"ulx slap"	"Grants access to the ulx slap command"
"wardrobe"	"Can the user use wardrobe?"
"ulx ragdoll"	"Grants access to the ulx ragdoll command"
"ulx wardrobeunblacklist"	"Grants access to the ulx wardrobeunblacklist command"
"ulx color"	"Grants access to the ulx color command"
"ulx fbring"	"Grants access to the ulx fbring command"
"ulx addgroup"	"Grants access to the ulx addgroup command"
"ulx stopvote"	"Grants access to the ulx stopvote command"
"ulx logechocolordefault"	"The default text color (RGB)"
"ulx unragdoll"	"Grants access to the ulx unragdoll command"
"ulx logechocolorconsole"	"The color that Console gets when using actions"
"ulx votebansuccessratio"	""
"ulx votemap"	"Grants access to the ulx votemap command"
"xgui_managebans"	"Allows addition, removal, and viewing of bans in XGUI."
"ulx logecho"	"Echo mode 0-Off 1-Anonymous 2-Full"
"ulx renamegroup"	"Grants access to the ulx renamegroup command"
"ulx setammo"	"Grants access to the ulx setammo command"
"ulx motdfile"	"MOTD filepath from gmod root to use if ulx showMotd is 1."
"ulx rslotsmode"	" - Sets the slots mode. See config for more information."
"wuma unrestrictuser"	"A privilege from CAMI"
"ulx unadmin"	"Grants access to the ulx unadmin command"
"ulx groupdeny"	"Grants access to the ulx groupdeny command"
"ulx sslay"	"Grants access to the ulx sslay command"
"ulx unmute"	"Grants access to the ulx unmute command"
"ulx unjail"	"Grants access to the ulx unjail command"
"ulx showmotd"	" <0/1/2/3> - MOTD mode. 0 is off."
"ulx unfreeze"	"Grants access to the ulx unfreeze command"
"ulx removehookcl"	"Grants access to the ulx removehookcl command"
"ulx votemap2minvotes"	""
"ulx resetcolor"	"Grants access to the ulx resetcolor command"
"ulx logchat"	"Log player chat"
"ulx reservedslots"	"Access to reserved slots"
"ulx exec"	"Grants access to the ulx exec command"
"wuma clearuserloadout"	"A privilege from CAMI"
"wuma setuserlimit"	"A privilege from CAMI"
"ulx multiban"	"Grants access to the ulx multiban command"
"ulx fteleport"	"Grants access to the ulx fteleport command"
"ulx spawnecho"	"Ability to see spawn echoes and steamids from joined players in console"
"wuma clearpersonalloadout"	"A privilege from CAMI"
"ulx kickbots"	"Grants access to the ulx kickbots command"
"xgui_svsettings"	"Allows changing of server and ULX-specific settings on the settings tab in XGUI."
"ulx unignite"	"Grants access to the ulx unignite command"
"ulx ignite"	"Grants access to the ulx ignite command"
"ulx adduserid"	"Grants access to the ulx adduserid command"
"xgui_managegroups"	"Allows managing of groups, users, and access strings via the groups tab in XGUI."
"ulx logechocolormisc"	"The color for anything else in echoes"
"ulx exit"	"Grants access to the ulx exit command"
"ulx logechocolorself"	"The color for yourself in echoes"
"ulx speed"	"Grants access to the ulx speed command"
"ulx setmodel"	"Grants access to the ulx setmodel command"
"ulx runscript"	"Grants access to the ulx runscript command"
"ulx votemapmapmode"	""
"ulx admin"	"Grants access to the ulx admin command"
"wuma unsetlimit"	"A privilege from CAMI"
"ulx veto"	"Grants access to the ulx veto command"
"ulx rcon"	"Grants access to the ulx rcon command"
"ulx administrate"	"Grants access to the ulx administrate command"
"ulx unbanip"	"Grants access to the ulx unbanip command"
"ulx logjoinleaveecho"	"Echo players leaves and joins to admins in the server (useful for banning minges)"
"ulx send"	"Grants access to the ulx send command"
"ulx seeanonymousechoes"	"Ability to see who uses a command even with ulx logEcho set to 1"
"ulx unwatch"	"Grants access to the ulx unwatch command"
"ulx resetdata"	"Grants access to the ulx resetdata command"
"wuma restrict"	"A privilege from CAMI"
"ulx printpgags"	"Grants access to the ulx printpgags command"
"ulx sit"	"Grants access to the ulx sit command"
